{
    "name": "Default Map", 
    "map": [
        "111111111",
        "120000001",
        "100000001",
        "100000021",
        "111111111"
    ]
}   